11111111111111111111
1P001000E10000111001
1000C000010000010001
10000000000000000001
10000000000000000001
10000000000000000001
10000001000000000001
10000000001000000001
1000000011C100000001
11110111001000000001
11111111111111111111
11111111111111111111
11111111111111111111
1110000C000000001111
11111111111111111111
11111111111111111111
11111111111111111111
11111111111111111111
11111111111111111111