111111111111111111111111111
1PE010000100001110011111111
1000C0000100000100011111111
100000000000000000011111111
100000000000000000011111111
100000000000000000011111111
100000010000000000011111111
100000000010000000011111111
1000000011C1000000011111111
111101110010000000011111111
111111111111111111111111111
111111111111111111111111111
111111111111111111111111111
1110000C0000000011111111111
111111111111111111111111111
111111100000000000000111111
111111110000000000001111111
111111111111111111111111111
111111111111111111111111111
