111111111111111111
1C01!E!00000000C11
1CCCC0C!0000000101
100000CC0C00000101
100C0000CP00000101
100000000C00000!01
100000000000000001
1111111!0!11111111
1C00000000000000C1
111111111111111111