111111111111111111
10C11E10000P0000C1
101!0C0!0111111101
100000C00C0000C101
101!010C0111111101
101!0100C000!00!01
1CC!C1000000000001
1111111!0!11111111
1CC00000000000CCC1
111111111111111111
