111111111111111111
1001!E!00000000011
10000C0!0000000101
100000CC0C00000101
10000000CP00000101
100000000000000!01
100000000000000001
1111111!0!11111111
100000000000000001
111111111111111111
