1111111111111111
100000E000000001
1000000000000001
1000000000000001
1000000000P00011
1000000000000001
1000000000000011
1111000011001111
1111111111111111