1111111111111111111111111
1!CCCCCCPCCCCCCCCCCCCC!11
1CCCCCCCCCCCCCCCCCCCCCC11
1CCCCCCCCCCCCCCCCCCCCCC11
1111111111111111111111C11
1CCCCCCCCCCCCCCCCCCCCCC11
1C11111111111111111111111
1CCCCCCCCCCCCCCCCCCCCCC11
1111111111111111111111C11
1CCCCCCCCCCCCCCCCCCCCCC11
1C11111111111111111111111
1CCCCCCCCCCCCCCCCCCCCCE11
1111111111111111111111111