11111111111111111111
1!CCCCCCPCCCCCCCCC!1
1CCCCCCCCCCCCCCCCCC1
1CCCCCCCCCCCCCCCCCC1
111111111111111111C1
1CCCCCCCCCCCCCCCCCC1
1C111111111111111111
1CCCCCCCCCCCCCCCCCC1
111111111111111111C1
1ECCCCCCCCCCCCCCCCC1
11111111111111111111