111111111111111111
10C11E10000P0000C1
10110C010111111101
100000C00C0000C101
1011010C0111111101
10110100C000000001
1CC1C1000000000001
111111110111111111
1CC00000000000CCC1
111111111111111111
